0BBRBGGB0G
RBBGBBR00R
RB00GBG00R
RBG00GG0RR
BR00RBGBRG