RG0G0BG0BR
0RBR0BB000
R0GBG00BRB
BR0R0RRGRG
0GGBGG0R0G