RGBGBGBRRG
BRGR0GRGBR
G0BG0R0RGB
BR00GBRGBR
G0BGBGBRGB